############
#g  #      #
#       #  #
#g g#   #pp#
#####   ####
#          #
#  #       #
#g #   #   #
#      # r #
###### #####
#g g     gg#
############